2, 2, 2, 2, 2, 2, 2, 2, 2, 2, 2, 2, 2,
2, 2, 2, 2, 2, 2, 2, 2, 2, 2, 2, 2, 2,
2, 2, 2, 2, 2, 2, 2, 2, 2, 2, 2, 2, 2,
2, 2, 2, 2, 2, 2, 1, 1, 1, 2, 2, 2, 2,
2, 2, 2, 2, 2, 2, 1, 5, 1, 2, 2, 2, 2,
2, 2, 2, 1, 1, 1, 1, 0, 1, 2, 2, 2, 2,
2, 2, 2, 1, 5, 0, 4, 4, 1, 1, 1, 2, 2,
2, 2, 2, 1, 1, 1, 0, 3, 4, 5, 1, 2, 2,
2, 2, 2, 2, 2, 1, 4, 1, 1, 1, 1, 2, 2,
2, 2, 2, 2, 2, 1, 5, 1, 2, 2, 2, 2, 2,
2, 2, 2, 2, 2, 1, 1, 1, 2, 2, 2, 2, 2,
2, 2, 2, 2, 2, 2, 2, 2, 2, 2, 2, 2, 2,
2, 2, 2, 2, 2, 2, 2, 2, 2, 2, 2, 2, 2,