2   2   2   2   2   2   2   2   2   2   2   2   2
2   2   2   2   2   2   2   2   2   2   2   2   2
2   2   2   2   2   2   2   2   2   2   2   2   2
2   2   2   2   2   2   2   2   2   2   2   2   2
2   2   2   2   2   2   2   2   2   2   2   2   2
2   2   2   2   1   1   1   1   1   1   1   2   2
2   2   2   1   1   3   1   1   5   5   1   2   2
2   2   2   1   0   4   4   0   4   5   1   2   2
2   2   2   1   0   0   0   4   0   9   1   2   2
2   2   2   1   1   1   1   0   0   5   1   2   2
2   2   2   2   2   2   1   1   1   1   1   2   2
2   2   2   2   2   2   2   2   2   2   2   2   2
2   2   2   2   2   2   2   2   2   2   2   2   2